06 10 04
XXXXXX
XXX..X
XXX.GX
X..J.X
X.G.GX
XXGJ.X
XX.JXX
XXJ.XX
XXM.XX
XXXXXX