05 07 02
XXXXX
XM..X
XJ..X
X..JX
XG..X
X..GX
XXXXX